14
6
7
#######
#E X X#
#     #
# #C#C#
#     #
#######