14
6
7
#######
# #X X#
# C   #
# ##C #
#E    #
#######