14
6
7
#######
#E    #
###C C#
#   # #
#  X X#
#######